player_id,Pos,Tm,G,GS,MP,FG,FGA,3P,3PA,2P,2PA,FT,FTA,ORB,DRB,TRB,AST,STL,BLK,TOV,PF,PTS,season_year,season_type
adebaba01,C,MIA,23,23,850,167,347,0,3,167,344,78,95,63,164,227,85,19,15,62,71,412,2023,playoff
aldamsa01,PF,MEM,6,0,101,15,33,7,15,8,18,2,2,7,19,26,7,3,0,2,5,39,2023,playoff
alexani01,SG,MIN,5,4,148,15,35,10,25,5,10,2,3,1,9,10,7,3,1,4,9,42,2023,playoff
allengr01,SG,MIL,5,5,149,19,41,14,29,5,12,6,7,1,11,12,9,2,0,4,7,58,2023,playoff
allenja01,C,CLE,5,5,191,22,36,0,0,22,36,3,6,15,22,37,12,4,5,3,10,47,2023,playoff
anderky01,PF,MIN,4,0,104,15,30,2,6,13,24,2,2,3,13,16,18,7,2,6,13,34,2023,playoff
antetgi01,PF,MIL,3,3,91,28,53,0,3,28,50,14,31,8,25,33,16,1,2,14,9,70,2023,playoff
antetth01,PF,MIL,2,0,5,0,0,0,0,0,0,0,0,0,0,0,0,0,0,0,0,0,2023,playoff
aytonde01,C,PHO,10,10,319,61,111,0,0,61,111,12,23,29,68,97,10,6,7,17,35,134,2023,playoff
baldwpa01,SF,GSW,3,0,11,0,3,0,3,0,0,0,0,0,3,3,1,0,0,0,0,0,2023,playoff
bambamo01,C,LAL,3,0,10,0,2,0,1,0,1,0,0,0,3,3,1,0,1,0,0,0,2023,playoff
banede01,SG,MEM,6,6,231,49,116,16,50,33,66,27,29,7,29,36,19,3,0,17,19,141,2023,playoff
barneha02,PF,SAC,7,7,196,25,60,6,25,19,35,19,26,10,14,24,5,8,2,3,5,75,2023,playoff
barrerj01,SG,NYK,11,11,377,71,164,20,61,51,103,50,65,5,44,49,31,9,2,25,25,212,2023,playoff
batumni01,PF,LAC,5,3,92,8,19,6,17,2,2,0,0,1,10,11,6,2,2,2,10,22,2023,playoff
beaslma01,SG,LAL,11,0,91,10,34,7,26,3,8,6,6,3,5,8,2,1,0,2,6,33,2023,playoff
beaucma01,SF,MIL,2,0,5,2,3,1,1,1,2,0,0,0,1,1,0,0,0,0,0,5,2023,playoff
beysa01,SF,ATL,6,0,133,15,40,7,18,8,22,8,9,7,17,24,6,3,0,2,3,45,2023,playoff
biyombi01,C,PHO,8,0,78,9,16,0,0,9,16,9,18,10,17,27,6,0,10,6,18,27,2023,playoff
bogdabo01,SG,ATL,6,1,157,30,54,15,33,15,21,5,7,2,16,18,15,6,5,3,16,80,2023,playoff
bookede01,SG,PHO,11,11,459,141,241,31,61,110,180,58,67,12,41,53,79,19,9,32,37,371,2023,playoff
bostobr01,SF,LAC,1,0,1,0,0,0,0,0,0,0,0,0,0,0,0,0,0,1,0,0,2023,playoff
braunch01,SG,DEN,19,0,247,24,45,2,10,22,35,11,19,12,27,39,11,11,4,10,29,61,2023,playoff
bridgmi01,SG,BRK,4,4,157,33,77,10,25,23,52,18,23,2,19,21,16,2,2,8,5,94,2023,playoff
brogdma01,PG,BOS,19,0,474,82,196,33,87,49,109,29,35,13,53,66,55,3,5,19,29,226,2023,playoff
brookdi01,SF,MEM,6,6,167,24,77,10,42,14,35,5,7,3,15,18,11,1,0,7,20,63,2023,playoff
brownbr01,SF,DEN,20,0,530,90,176,18,57,72,119,42,49,15,65,80,38,21,9,23,49,240,2023,playoff
brownja02,SF,BOS,20,20,751,181,365,40,113,141,252,51,74,25,87,112,68,21,8,66,61,453,2023,playoff
browntr01,SF,LAL,12,0,124,10,28,2,15,8,13,0,0,4,20,24,11,2,1,0,4,22,2023,playoff
brunsja01,PG,NYK,11,11,443,109,230,26,80,83,150,62,68,9,45,54,62,16,1,23,26,306,2023,playoff
bryanth01,C,DEN,1,0,0,0,0,0,0,0,0,0,0,0,0,0,0,0,0,0,0,0,2023,playoff
butleji01,PF,MIA,22,22,874,207,442,28,78,179,364,150,186,47,95,142,129,40,14,41,37,592,2023,playoff
caldwke01,SG,DEN,20,20,671,74,162,35,92,39,70,29,35,14,51,65,31,26,13,15,48,212,2023,playoff
cancavl01,PF,DEN,5,0,10,0,5,0,4,0,1,0,0,0,3,3,1,0,0,0,0,0,2023,playoff
capelca01,C,ATL,6,6,151,23,38,0,0,23,38,4,6,15,35,50,3,6,3,4,5,50,2023,playoff
carteje01,PG,MIL,4,0,49,2,9,1,7,1,2,0,0,0,4,4,4,1,0,0,1,5,2023,playoff
champju01,SF,BOS,4,0,10,1,4,0,3,1,1,0,0,0,0,0,0,0,0,0,2,2,2023,playoff
chrisma02,SG,LAL,9,0,33,5,10,1,4,4,6,2,4,1,6,7,3,0,1,0,0,13,2023,playoff
claxtni01,C,BRK,4,4,117,18,25,0,0,18,25,6,10,5,27,32,6,1,7,3,8,42,2023,playoff
coffeam01,SF,LAC,1,0,1,0,0,0,0,0,0,0,0,0,0,0,0,0,0,0,0,0,2023,playoff
collijo01,PF,ATL,6,6,164,26,60,11,32,15,28,5,6,7,19,26,5,2,6,9,13,68,2023,playoff
conlemi01,PG,MIN,5,5,183,20,42,10,22,10,20,10,11,2,11,13,32,3,0,7,11,60,2023,playoff
connapa01,SF,MIL,4,0,88,17,30,11,23,6,7,3,4,4,16,20,7,4,1,2,10,48,2023,playoff
covinro01,PF,LAC,2,0,12,0,3,0,2,0,1,0,0,0,2,2,2,0,1,0,2,0,2023,playoff
craigto01,PF,PHO,11,5,183,26,45,11,25,15,20,8,9,7,18,25,6,5,2,3,23,71,2023,playoff
crowdja01,PF,MIL,4,0,41,3,13,0,6,3,7,1,2,1,3,4,3,2,0,1,5,7,2023,playoff
curryse01,SG,BRK,3,0,58,10,19,3,9,7,10,2,3,0,3,3,6,0,0,1,2,25,2023,playoff
curryst01,PG,GSW,13,13,493,145,311,57,157,88,154,49,58,9,58,67,79,13,6,42,34,396,2023,playoff
davisan02,C,LAL,16,16,608,132,254,5,15,127,239,92,108,38,187,225,41,22,50,34,46,361,2023,playoff
daviste02,SG,SAC,4,0,58,8,20,6,17,2,3,2,2,2,7,9,6,1,0,2,12,24,2023,playoff
dedmode01,C,PHI,1,0,5,0,1,0,1,0,0,0,0,0,1,1,0,0,0,1,1,0,2023,playoff
dinwisp01,PG,BRK,4,4,159,22,51,7,18,15,33,15,22,1,12,13,26,5,1,12,7,66,2023,playoff
divindo01,SG,GSW,13,1,235,24,64,15,44,9,20,8,12,11,28,39,36,11,3,17,20,71,2023,playoff
doziepj01,SF,SAC,3,0,6,3,6,2,4,1,2,0,0,1,1,2,0,0,0,0,0,8,2023,playoff
dragigo01,PG,MIL,2,0,7,0,2,0,1,0,1,4,4,0,0,0,1,0,0,0,0,4,2023,playoff
dukeda01,SG,BRK,1,0,5,1,3,0,1,1,2,0,0,0,0,0,0,0,0,1,1,2,2023,playoff
duranke01,PF,PHO,11,11,466,107,224,17,51,90,173,88,96,7,89,96,61,9,15,39,29,319,2023,playoff
edwaran01,SG,MIN,5,5,199,55,114,15,43,40,71,33,39,3,22,25,26,9,10,8,13,158,2023,playoff
edwarke02,SF,SAC,6,0,7,0,0,0,0,0,0,0,0,0,1,1,0,0,0,0,0,0,2023,playoff
embiijo01,C,PHI,9,9,336,66,153,5,28,61,125,76,84,16,72,88,24,6,25,35,27,213,2023,playoff
finnedo01,PF,BRK,4,4,101,9,23,7,17,2,6,0,0,6,12,18,3,3,2,5,7,25,2023,playoff
foxde01,PG,SAC,7,7,270,70,165,21,63,49,102,31,41,12,26,38,54,15,4,28,23,192,2023,playoff
gabriwe01,C,LAL,10,0,37,4,10,0,0,4,10,2,3,8,1,9,0,2,3,2,8,10,2023,playoff
garlada01,PG,CLE,5,5,189,35,80,12,31,23,49,21,25,0,9,9,25,8,1,18,17,103,2023,playoff
goberru01,C,MIN,5,5,177,29,46,0,0,29,46,17,27,18,43,61,10,2,5,8,24,75,2023,playoff
gordoaa01,PF,DEN,20,20,713,101,195,18,46,83,149,45,69,49,71,120,52,11,13,20,58,265,2023,playoff
gordoer01,SG,LAC,5,5,149,18,44,10,29,8,15,5,6,1,6,7,13,3,2,4,12,51,2023,playoff
greenda02,SG,CLE,4,0,40,1,5,1,4,0,1,0,0,2,5,7,1,2,1,2,7,3,2023,playoff
greendr01,PF,GSW,12,9,367,42,91,5,20,37,71,24,33,19,64,83,82,18,12,27,48,113,2023,playoff
greenja01,PF,GSW,7,2,49,9,23,5,18,4,5,0,0,0,5,5,3,0,1,2,10,23,2023,playoff
greenje02,PF,DEN,20,0,343,28,62,9,28,19,34,17,19,6,25,31,14,5,7,9,43,82,2023,playoff
griffbl01,C,BOS,1,0,6,0,1,0,0,0,1,0,0,1,1,2,0,0,0,0,2,0,2023,playoff
grimequ01,SG,NYK,9,6,242,14,46,9,37,5,9,9,11,3,22,25,13,9,5,10,17,46,2023,playoff
hachiru01,PF,LAL,16,1,388,73,131,19,39,54,92,30,34,9,49,58,10,8,4,10,25,195,2023,playoff
hardeja01,PG,PHI,11,11,427,72,183,31,82,41,101,48,55,6,62,68,91,20,4,35,28,223,2023,playoff
harremo01,C,PHI,2,0,7,0,3,0,0,0,3,0,0,0,1,1,0,0,0,0,0,0,2023,playoff
harrijo01,SF,BRK,4,0,44,2,13,1,12,1,1,2,2,0,5,5,0,2,0,3,5,7,2023,playoff
harrito02,SF,PHI,11,11,392,70,134,15,41,55,93,13,15,17,63,80,18,7,6,8,28,168,2023,playoff
harrish01,SG,LAL,8,0,28,4,7,1,1,3,6,1,2,0,3,3,9,2,0,0,3,10,2023,playoff
hartjo01,SF,NYK,11,5,353,45,94,10,32,35,62,14,22,18,63,81,24,9,3,21,38,114,2023,playoff
harteis01,C,NYK,11,0,220,11,23,0,0,11,23,12,16,23,28,51,14,9,15,5,29,34,2023,playoff
hasleud01,C,MIA,2,0,3,0,3,0,1,0,2,0,0,0,1,1,0,0,0,0,0,0,2023,playoff
hausesa01,SF,BOS,15,0,104,10,29,8,24,2,5,2,2,5,12,17,4,1,2,0,8,30,2023,playoff
herroty01,SG,MIA,1,1,19,5,9,2,4,3,5,0,0,0,2,2,2,0,1,1,1,12,2023,playoff
highsha01,PF,MIA,18,0,161,24,39,8,16,16,23,4,5,10,14,24,5,10,2,2,20,60,2023,playoff
holidaa01,PG,ATL,1,0,4,0,0,0,0,0,0,0,0,0,0,0,1,0,0,1,0,0,2023,playoff
holidjr01,PG,MIL,5,5,191,34,85,12,42,22,43,9,13,4,29,33,40,5,2,12,12,89,2023,playoff
horfoal01,C,BOS,20,20,617,51,132,28,94,23,38,3,4,30,113,143,59,22,34,11,47,133,2023,playoff
houseda01,SF,PHI,7,0,42,9,21,1,10,8,11,1,1,0,12,12,1,0,0,1,4,20,2023,playoff
huertke01,SG,SAC,7,7,183,25,72,8,39,17,33,6,8,1,30,31,8,3,9,4,23,64,2023,playoff
huntede01,SF,ATL,6,6,224,39,85,14,38,25,47,8,10,7,27,34,7,4,2,9,20,100,2023,playoff
hylanbo01,PG,LAC,5,0,82,15,44,5,20,10,24,8,10,1,3,4,4,4,1,4,9,43,2023,playoff
inglejo01,SF,MIL,5,0,89,12,23,10,20,2,3,0,0,1,5,6,10,3,1,6,7,34,2023,playoff
jacksja02,C,MEM,6,6,220,35,83,7,25,28,58,31,36,20,27,47,9,6,12,18,24,108,2023,playoff
jacksre01,PG,DEN,6,0,18,1,2,1,2,0,0,0,0,0,2,2,2,1,0,1,0,3,2023,playoff
jamesle01,PF,LAL,16,16,619,147,295,28,106,119,189,70,92,25,133,158,104,17,18,40,28,392,2023,playoff
jeffrda01,SG,NYK,2,0,5,0,0,0,0,0,0,0,0,0,0,0,0,0,0,0,2,0,2023,playoff
johnsca02,PF,BRK,4,4,152,28,55,12,28,16,27,6,7,3,20,23,11,3,1,5,10,74,2023,playoff
johnsja05,SF,ATL,6,0,56,10,24,4,11,6,13,2,2,2,13,15,8,3,0,5,5,26,2023,playoff
jokicni01,C,DEN,20,20,789,227,414,35,76,192,338,111,139,69,200,269,190,21,20,70,69,600,2023,playoff
jonesty01,PG,MEM,6,1,120,11,36,3,19,8,17,2,3,3,15,18,22,8,0,8,5,27,2023,playoff
jordade01,C,DEN,4,0,14,2,3,0,0,2,3,1,2,0,4,4,1,0,1,2,2,5,2023,playoff
jovicni01,PF,MIA,7,0,13,1,4,0,2,1,2,0,0,1,4,5,0,0,0,0,0,2,2023,playoff
kennalu01,SG,MEM,5,0,107,12,23,8,16,4,7,4,4,5,15,20,7,4,0,1,8,36,2023,playoff
knighna01,C,MIN,2,0,5,1,4,0,2,1,2,0,0,1,0,1,0,0,0,1,0,2,2023,playoff
konchjo01,SF,MEM,5,0,49,2,9,0,4,2,5,0,0,4,6,10,4,2,2,1,6,4,2023,playoff
korkmfu01,SG,PHI,3,0,11,0,2,0,1,0,1,2,2,0,1,1,1,0,0,1,0,2,2023,playoff
kornelu01,C,BOS,8,0,32,7,8,1,1,6,7,2,2,5,5,10,0,0,1,0,2,17,2023,playoff
kuminjo01,PF,GSW,10,0,61,13,24,3,7,10,17,5,9,4,5,9,5,2,0,4,5,34,2023,playoff
lamban01,SF,GSW,6,0,31,2,5,1,4,1,1,0,0,1,5,6,0,1,1,2,3,5,2023,playoff
landajo01,C,PHO,7,1,113,17,27,0,1,17,26,9,14,10,18,28,3,3,3,2,15,43,2023,playoff
leeda03,SG,PHO,8,0,89,6,20,3,15,3,5,2,2,4,7,11,5,2,0,1,8,17,2023,playoff
lenal01,C,SAC,7,0,54,7,9,0,0,7,9,5,6,7,13,20,1,0,3,7,15,19,2023,playoff
leonaka01,SF,LAC,2,2,80,24,44,6,10,18,34,15,17,3,10,13,12,4,1,6,5,69,2023,playoff
leoname01,C,MIL,2,0,5,0,1,0,0,0,1,0,0,0,1,1,0,0,0,0,0,0,2023,playoff
leverca01,SG,CLE,5,3,170,27,63,13,36,14,27,8,13,4,19,23,13,2,1,5,10,75,2023,playoff
loftoke01,PF,MEM,4,0,12,3,8,0,2,3,6,1,2,1,2,3,1,0,0,0,0,7,2023,playoff
looneke01,C,GSW,13,8,325,37,64,0,0,37,64,10,18,61,109,170,43,8,5,13,36,84,2023,playoff
lopezbr01,C,MIL,5,5,182,39,67,7,17,32,50,10,13,14,18,32,6,7,9,11,10,95,2023,playoff
lopezro01,C,CLE,2,0,6,3,3,0,0,3,3,2,2,1,0,1,0,0,0,1,2,8,2023,playoff
loveke01,PF,MIA,20,18,359,45,119,33,88,12,31,14,16,14,97,111,24,9,7,10,35,137,2023,playoff
lowryky01,PG,MIA,23,1,599,74,174,33,88,41,86,31,33,12,69,81,101,24,14,40,59,212,2023,playoff
lylestr01,PF,SAC,7,0,118,17,40,9,27,8,13,3,5,9,31,40,5,2,0,3,12,46,2023,playoff
mannte01,SG,LAC,5,0,133,19,33,9,19,10,14,6,9,7,9,16,11,4,1,9,17,53,2023,playoff
martica02,SF,MIA,23,4,694,109,206,44,104,65,102,29,35,27,98,125,36,20,9,24,55,291,2023,playoff
matthwe02,SF,MIL,2,0,41,4,9,4,7,0,2,0,0,1,2,3,1,2,1,0,3,12,2023,playoff
maxeyty01,SG,PHI,11,11,423,82,192,34,85,48,107,28,31,9,44,53,25,15,5,8,26,226,2023,playoff
mcbrimi01,PG,NYK,8,0,20,1,4,1,3,0,1,0,0,0,2,2,1,0,1,0,1,3,2023,playoff
mcdanja01,SF,PHI,8,0,102,8,20,3,9,5,11,0,0,3,13,16,5,1,0,3,8,19,2023,playoff
mclaujo01,PG,MIN,2,0,14,0,4,0,2,0,2,0,0,0,2,2,2,0,0,0,2,0,2023,playoff
meltode01,SG,PHI,11,0,274,31,81,19,49,12,32,6,8,14,22,36,18,13,9,8,20,87,2023,playoff
metuch01,PF,SAC,3,0,6,0,1,0,0,0,1,2,3,1,0,1,0,0,0,1,0,2,2023,playoff
middlkh01,SF,MIL,5,5,173,40,86,13,32,27,54,26,30,7,25,32,31,3,0,17,15,119,2023,playoff
millspa02,PG,BRK,1,0,5,0,2,0,2,0,0,0,0,0,0,0,0,0,0,0,1,0,2023,playoff
miltosh01,SG,PHI,6,0,21,3,5,0,1,3,4,2,2,0,3,3,2,2,0,1,3,8,2023,playoff
minotjo01,SF,MIN,1,0,6,0,1,0,1,0,0,0,0,0,0,0,0,2,1,1,1,0,2023,playoff
mitchda01,PG,SAC,7,0,140,19,46,7,27,12,19,5,6,3,6,9,12,6,1,6,7,50,2023,playoff
mitchdo01,SG,CLE,5,5,207,45,104,13,45,32,59,13,18,3,22,25,36,10,3,19,14,116,2023,playoff
mobleev01,PF,CLE,5,5,188,22,48,0,1,22,47,5,8,15,35,50,10,3,6,12,13,49,2023,playoff
monkma01,SG,SAC,7,0,205,38,93,13,39,25,54,44,49,6,32,38,25,5,3,14,15,133,2023,playoff
moodymo01,SG,GSW,12,0,161,23,43,13,22,10,21,11,12,7,24,31,8,5,4,2,18,70,2023,playoff
moorewe01,SG,MIN,1,0,2,0,0,0,0,0,0,0,0,0,0,0,0,0,0,1,0,0,2023,playoff
moranja01,PG,MEM,5,5,187,45,106,13,31,32,75,20,26,8,26,34,35,9,1,17,12,123,2023,playoff
morrima03,PF,LAC,3,2,68,10,29,2,12,8,17,4,4,1,11,12,0,1,1,1,6,26,2023,playoff
murrade01,SG,ATL,5,5,190,46,103,14,37,32,66,9,9,9,27,36,34,10,1,10,7,115,2023,playoff
murraja01,PG,DEN,20,20,799,194,410,59,149,135,261,75,81,15,98,113,142,30,5,50,41,522,2023,playoff
murrake02,SF,SAC,7,7,194,26,58,12,32,14,26,4,6,15,29,44,5,4,2,4,18,68,2023,playoff
muscami01,C,BOS,6,0,21,2,4,2,4,0,0,3,4,3,1,4,1,0,0,1,1,9,2023,playoff
netora01,PG,CLE,2,0,7,0,1,0,1,0,0,1,2,0,0,0,1,0,0,2,2,1,2023,playoff
niangge01,PF,PHI,11,0,157,18,36,12,26,6,10,0,0,0,4,4,2,0,2,5,16,48,2023,playoff
nnajize01,PF,DEN,5,0,12,2,4,1,3,1,1,0,0,0,2,2,0,1,0,1,0,5,2023,playoff
nowelja01,SG,MIN,5,0,62,6,26,3,9,3,17,1,2,4,1,5,3,0,0,2,4,16,2023,playoff
onealro01,SF,BRK,4,0,118,7,29,4,22,3,7,2,2,4,13,17,14,5,1,4,11,20,2023,playoff
okogijo01,SG,PHO,10,5,175,14,37,2,14,12,23,11,13,12,9,21,13,6,2,3,18,41,2023,playoff
okongon01,C,ATL,6,0,131,15,25,1,1,14,24,5,10,19,19,38,7,2,8,7,18,36,2023,playoff
okorois01,SF,CLE,5,2,75,11,23,4,13,7,10,6,6,3,4,7,4,2,2,4,10,32,2023,playoff
oladivi01,SG,MIA,2,0,45,10,19,2,5,8,14,1,3,1,6,7,2,2,1,2,5,23,2023,playoff
osmande01,SF,CLE,5,0,93,9,25,6,20,3,5,6,9,1,14,15,5,2,1,5,12,30,2023,playoff
paulch01,PG,PHO,7,7,250,38,91,9,28,29,63,2,4,5,30,35,52,12,5,7,16,87,2023,playoff
payneca01,PG,PHO,7,4,152,23,48,11,27,12,21,0,3,0,14,14,20,3,2,9,15,57,2023,playoff
paytoga02,SG,GSW,12,3,192,36,54,4,15,32,39,6,9,22,22,44,9,8,6,11,19,82,2023,playoff
plumlma01,C,LAC,5,0,91,14,16,0,0,14,16,13,14,16,18,34,9,2,2,3,15,41,2023,playoff
poolejo01,PG,GSW,13,4,284,46,135,16,63,30,72,26,34,4,24,28,46,10,3,15,32,134,2023,playoff
portemi01,SF,DEN,20,20,654,99,234,46,131,53,103,23,29,20,142,162,31,10,11,9,42,267,2023,playoff
portibo01,PF,MIL,5,2,107,20,41,5,18,15,23,3,3,10,31,41,6,3,2,4,15,48,2023,playoff
powelno01,SG,LAC,5,3,167,36,76,13,32,23,44,24,31,4,11,15,11,4,2,8,16,109,2023,playoff
prestja01,PG,LAC,1,0,1,0,0,0,0,0,0,0,0,0,0,0,0,0,0,0,0,0,2023,playoff
princta02,PF,MIN,5,1,100,12,33,8,21,4,12,7,9,3,4,7,4,3,1,5,9,39,2023,playoff
pritcpa01,PG,BOS,10,0,57,12,22,4,10,8,12,4,5,0,6,6,11,1,0,5,3,32,2023,playoff
quickim01,SG,NYK,8,0,175,23,66,9,37,14,29,17,20,2,11,13,8,4,0,9,11,72,2023,playoff
randlju01,PF,NYK,10,10,330,55,147,17,66,38,81,39,55,17,66,83,36,5,3,35,24,166,2023,playoff
reaveau01,SG,LAL,16,16,579,90,194,39,88,51,106,51,57,20,51,71,73,10,3,25,39,270,2023,playoff
reedpa01,C,PHI,11,2,157,22,38,0,0,22,38,7,7,27,33,60,7,6,4,6,15,51,2023,playoff
riverau01,SG,MIN,4,0,46,4,8,2,6,2,2,0,0,1,4,5,1,1,0,1,1,10,2023,playoff
robindu01,SF,MIA,23,1,418,75,158,50,113,25,45,7,8,1,33,34,39,8,3,20,36,207,2023,playoff
robinmi01,C,NYK,11,11,298,29,48,0,0,29,48,13,33,55,47,102,9,8,16,10,29,71,2023,playoff
roddyda01,PF,MEM,6,0,76,8,29,6,20,2,9,1,1,4,13,17,4,0,2,1,6,23,2023,playoff
rosede01,PG,NYK,1,0,3,0,4,0,1,0,3,0,0,0,0,0,1,0,0,0,0,0,2023,playoff
rosste01,SG,PHO,6,0,69,8,27,6,22,2,5,0,0,0,8,8,1,1,2,1,6,22,2023,playoff
rubiori01,PG,CLE,3,0,17,0,1,0,0,0,1,0,0,2,4,6,3,1,0,5,5,0,2023,playoff
russeda01,PG,LAL,16,15,473,83,195,27,87,56,108,20,26,10,37,47,74,11,5,29,32,213,2023,playoff
sabondo01,C,SAC,7,7,243,49,99,1,5,48,94,16,28,31,46,77,33,10,6,26,28,115,2023,playoff
schrode01,PG,LAL,16,3,417,41,103,13,39,28,64,23,28,3,28,31,46,16,3,20,40,118,2023,playoff
shamela01,SG,PHO,10,1,184,17,45,11,29,6,16,3,4,3,14,17,11,2,1,4,15,48,2023,playoff
sharpda01,C,BRK,2,0,20,2,3,0,0,2,3,2,2,2,4,6,5,0,1,2,3,6,2023,playoff
smartma01,PG,BOS,20,20,679,101,223,44,122,57,101,52,65,21,59,80,101,25,5,45,37,298,2023,playoff
smithis01,PG,DEN,4,0,12,1,2,0,0,1,2,0,0,0,1,1,1,0,0,0,2,2,2023,playoff
sprinja01,SG,PHI,4,0,17,4,4,0,0,4,4,1,2,0,0,0,0,1,0,1,2,9,2023,playoff
stevela01,SF,CLE,2,0,9,1,2,1,1,0,1,2,2,0,3,3,0,0,0,0,0,5,2023,playoff
strusma01,SF,MIA,23,23,648,76,189,43,135,33,54,20,25,14,69,83,33,8,7,6,47,215,2023,playoff
sumneed01,SG,BRK,1,0,4,0,0,0,0,0,0,0,0,0,0,0,1,0,0,0,0,0,2023,playoff
tatumja01,SF,BOS,20,20,799,185,404,53,164,132,240,120,137,26,184,210,105,21,21,56,44,543,2023,playoff
thomaca02,SG,BRK,2,0,16,3,7,0,2,3,5,0,0,0,1,1,1,0,0,1,2,6,2023,playoff
thompkl01,SF,GSW,13,13,468,85,219,50,136,35,83,21,24,1,53,54,29,7,4,26,28,241,2023,playoff
thomptr01,C,LAL,6,0,32,5,11,0,0,5,11,1,5,4,6,10,2,0,0,1,1,11,2023,playoff
tillmxa01,C,MEM,6,6,183,24,45,1,4,23,41,3,5,17,31,48,19,4,4,4,17,52,2023,playoff
toppiob01,PF,NYK,11,1,175,30,70,13,43,17,27,4,5,10,29,39,7,8,3,8,12,77,2023,playoff
townska01,PF,MIN,5,5,180,32,70,6,24,26,46,21,28,6,45,51,10,3,4,18,21,91,2023,playoff
tuckepj01,PF,PHI,11,11,294,19,51,14,40,5,11,2,3,18,32,50,16,13,3,5,28,54,2023,playoff
vandeja01,PF,LAL,15,13,247,24,60,7,29,17,31,14,20,19,29,48,12,11,12,13,31,69,2023,playoff
vincega01,PG,MIA,22,22,672,99,246,51,135,48,111,30,34,8,23,31,78,19,4,31,66,279,2023,playoff
wadede01,PF,CLE,2,0,11,0,1,0,1,0,0,2,2,0,3,3,0,0,0,0,0,2,2023,playoff
wainris01,SF,PHO,6,0,21,1,4,1,4,0,0,0,0,0,1,1,0,0,1,0,2,3,2023,playoff
walkelo01,SG,LAL,13,0,179,29,60,13,34,16,26,9,12,1,11,12,11,7,1,4,16,80,2023,playoff
warretj01,SF,PHO,6,0,81,6,19,1,7,5,12,3,4,2,5,7,3,1,3,1,5,16,2023,playoff
watanyu01,SF,BRK,1,0,5,1,2,1,2,0,0,0,2,0,1,1,0,0,0,1,0,3,2023,playoff
watsope01,SG,DEN,5,0,14,2,5,1,2,1,3,0,0,1,3,4,1,0,1,1,2,5,2023,playoff
westbru01,PG,LAC,5,5,192,43,105,10,28,33,77,22,25,9,29,38,37,6,7,20,15,118,2023,playoff
whitede01,SG,BOS,20,16,593,93,184,50,110,43,74,31,34,13,46,59,42,12,20,18,38,267,2023,playoff
wiggian01,SF,GSW,13,12,442,83,181,19,64,64,117,32,47,24,49,73,25,11,15,17,45,217,2023,playoff
willigr01,PF,BOS,15,0,265,25,53,18,40,7,13,8,10,11,22,33,18,5,6,4,25,76,2023,playoff
williro04,C,BOS,20,4,417,67,85,0,1,67,84,19,28,36,83,119,19,9,25,16,44,153,2023,playoff
willizi02,SF,MEM,4,0,12,2,7,1,3,1,4,0,0,0,2,2,2,0,0,2,1,5,2023,playoff
youngtr01,PG,ATL,6,6,230,60,149,18,54,42,95,37,43,5,17,22,61,10,4,24,11,175,2023,playoff
yurtsom01,C,MIA,8,0,16,2,7,0,2,2,5,0,0,3,2,5,1,0,1,1,2,4,2023,playoff
zelleco01,C,MIA,21,0,174,20,35,0,0,20,35,6,15,11,37,48,7,2,4,13,28,46,2023,playoff
zubaciv01,C,LAC,5,5,130,17,30,0,0,17,30,12,16,16,32,48,3,3,1,11,8,46,2023,playoff
achiupr01,PF,NYK,9,2,184,21,43,0,3,21,40,5,13,22,16,38,5,4,12,4,20,47,2024,playoff
adebaba01,C,MIA,5,5,192,48,97,2,10,46,87,15,21,11,36,47,19,2,0,8,15,113,2024,playoff
alexani01,SG,MIN,16,1,378,41,112,24,81,17,31,10,10,5,23,28,37,10,7,15,24,116,2024,playoff
allengr01,SG,PHO,2,2,43,1,5,1,5,0,0,4,4,2,6,8,2,1,0,3,4,7,2024,playoff
allenja01,C,CLE,4,4,127,25,37,0,0,25,37,18,26,15,40,55,5,5,4,5,8,68,2024,playoff
alvarjo01,PG,NOP,4,0,62,3,20,1,14,2,6,0,0,0,4,4,9,5,1,4,3,7,2024,playoff
anderky01,PF,MIN,15,1,231,26,57,2,8,24,49,10,12,18,22,40,38,10,5,10,26,64,2024,playoff
antetth01,PF,MIL,2,0,5,0,0,0,0,0,0,0,0,0,0,0,0,1,1,0,1,0,2024,playoff
anthoco01,PG,ORL,7,0,103,13,41,2,13,11,28,8,9,2,13,15,9,4,1,5,16,36,2024,playoff
anunoog01,SF,NYK,9,9,324,56,111,16,39,40,72,8,13,7,47,54,10,8,9,10,15,136,2024,playoff
banchpa01,PF,ORL,7,7,262,68,149,16,40,52,109,37,49,14,46,60,28,8,4,32,14,189,2024,playoff
batumni01,PF,PHI,6,0,170,12,29,9,22,3,7,5,8,9,26,35,8,1,5,5,13,38,2024,playoff
bealbr01,SG,PHO,4,4,154,26,59,10,23,16,36,4,5,6,5,11,18,3,1,13,15,66,2024,playoff
beaslma01,SG,MIL,6,2,131,21,41,11,25,10,16,0,0,1,14,15,4,4,0,3,9,53,2024,playoff
beaucma01,SF,MIL,4,0,10,1,4,0,2,1,2,1,2,0,1,1,2,0,0,1,1,3,2024,playoff
beverpa01,PG,MIL,6,6,210,16,39,4,11,12,28,13,15,4,16,20,33,6,4,6,16,49,2024,playoff
bitadgo01,C,ORL,2,0,10,0,2,0,0,0,2,0,0,1,2,3,2,0,0,1,0,0,2024,playoff
blackan01,PG,ORL,2,0,11,3,7,0,2,3,5,0,0,1,1,2,2,1,0,1,1,6,2024,playoff
bogdabo02,SF,NYK,4,0,51,7,24,6,15,1,9,4,7,1,11,12,4,0,1,1,3,24,2024,playoff
bolbo01,PF,PHO,3,0,13,1,3,0,0,1,3,0,0,0,4,4,0,1,0,0,2,2,2024,playoff
bookede01,PG,PHO,4,4,166,32,65,7,20,25,45,39,41,1,12,13,24,7,1,11,18,110,2024,playoff
bostobr01,SF,LAC,3,0,10,2,4,0,0,2,4,1,2,1,1,2,1,0,0,0,2,5,2024,playoff
braunch01,SG,DEN,12,0,204,23,54,4,18,19,36,11,16,9,23,32,9,2,5,1,18,61,2024,playoff
brissos01,SF,BOS,10,0,55,6,11,2,2,4,9,2,4,3,11,14,0,3,2,1,2,16,2024,playoff
brownja02,SF,BOS,19,19,707,175,339,36,110,139,229,68,103,22,91,113,62,23,12,51,51,454,2024,playoff
brownke03,SG,IND,7,0,25,2,6,0,0,2,6,0,0,0,3,3,2,0,1,3,2,4,2024,playoff
brownko01,PF,LAC,3,0,10,0,0,0,0,0,0,0,0,1,1,2,0,0,0,0,1,0,2024,playoff
brunsja01,PG,NYK,13,13,518,151,340,26,84,125,256,93,120,8,35,43,97,10,2,35,26,421,2024,playoff
bryanth01,C,MIA,2,0,18,5,7,0,2,5,5,2,3,2,3,5,1,0,0,2,1,12,2024,playoff
burksal01,SG,NYK,6,0,121,25,50,12,28,13,22,27,32,4,16,20,6,1,1,0,6,89,2024,playoff
caldwke01,SG,DEN,12,12,420,34,86,18,55,16,31,11,11,5,30,35,31,17,5,10,37,97,2024,playoff
cartewe01,C,ORL,7,5,185,19,47,7,25,12,22,8,11,9,35,44,9,5,4,5,20,53,2024,playoff
coffeam01,SF,LAC,6,3,112,7,22,3,11,4,11,0,0,2,8,10,2,2,1,5,6,17,2024,playoff
conlemi01,PG,MIN,15,15,474,62,145,30,76,32,69,20,28,10,48,58,86,21,3,20,38,174,2024,playoff
connapa01,SF,MIL,6,0,124,11,25,3,11,8,14,2,2,3,20,23,13,6,1,3,6,27,2024,playoff
crowdja01,PF,MIL,4,0,42,3,12,1,7,2,5,2,2,2,4,6,2,0,2,0,4,9,2024,playoff
daniedy01,PG,NOP,3,0,17,2,6,0,2,2,4,0,0,0,2,2,0,2,0,1,0,4,2024,playoff
davisan02,C,LAL,5,5,208,59,93,0,5,59,88,21,26,15,63,78,20,2,8,11,19,139,2024,playoff
diakima01,PF,NYK,4,0,15,0,3,0,2,0,1,2,2,0,3,3,1,1,1,1,3,2,2024,playoff
diengou01,PF,OKC,4,0,7,1,2,0,1,1,1,0,0,0,0,0,0,0,0,0,0,2,2024,playoff
dinwisp01,PG,LAL,5,0,73,5,14,2,8,3,6,3,6,1,6,7,8,2,1,1,7,15,2024,playoff
divindo01,SG,NYK,13,13,466,80,191,45,106,35,85,26,30,13,39,52,34,16,12,16,29,231,2024,playoff
doncilu01,PG,DAL,22,22,900,225,504,68,211,157,293,117,153,16,192,208,178,41,8,90,56,635,2024,playoff
dortlu01,SF,OKC,10,10,350,33,91,25,64,8,27,16,19,19,27,46,20,13,2,11,42,107,2024,playoff
duranke01,PF,PHO,4,4,168,37,67,5,12,32,55,28,34,1,25,26,13,2,6,10,8,107,2024,playoff
edwaran01,SG,MIN,16,16,649,156,324,46,115,110,209,83,102,18,94,112,104,24,9,52,37,441,2024,playoff
embiijo01,C,PHI,6,6,248,59,133,13,39,46,94,67,78,19,46,65,34,7,9,25,20,198,2024,playoff
eubandr01,C,PHO,3,0,37,7,12,0,0,7,12,3,3,0,4,4,0,2,1,2,6,17,2024,playoff
exumda01,PG,DAL,21,0,144,16,44,7,20,9,24,4,6,3,14,17,12,3,1,5,9,43,2024,playoff
fultzma01,PG,ORL,7,0,106,20,34,0,1,20,33,5,9,7,7,14,8,3,0,8,12,45,2024,playoff
gaffoda01,PF,DAL,22,22,445,78,123,0,0,78,123,41,65,42,80,122,15,6,33,19,38,197,2024,playoff
gallida01,SF,MIL,3,0,37,4,8,0,2,4,6,3,4,1,8,9,2,0,0,1,0,11,2024,playoff
garlada01,PG,CLE,12,12,432,73,171,25,71,48,100,17,21,1,42,43,69,13,2,27,33,188,2024,playoff
garzalu01,C,MIN,7,0,26,10,12,2,3,8,9,7,8,2,4,6,1,0,0,0,0,29,2024,playoff
georgpa01,PF,LAC,6,6,222,39,95,18,49,21,46,21,25,3,38,41,29,7,3,14,22,117,2024,playoff
giddejo01,SG,OKC,10,8,181,34,75,12,34,22,41,7,8,7,29,36,21,2,4,12,9,87,2024,playoff
gilgesh01,PG,OKC,10,10,399,111,224,16,37,95,187,64,81,8,64,72,64,13,17,22,31,302,2024,playoff
goberru01,C,MIN,15,15,512,64,104,0,0,64,104,53,79,40,107,147,24,14,15,23,55,181,2024,playoff
gordoaa01,PF,DEN,12,12,445,69,118,11,27,58,91,23,28,36,51,87,53,10,7,18,28,172,2024,playoff
gordoer01,SG,PHO,4,0,118,9,28,7,17,2,11,7,8,1,6,7,5,5,2,4,5,32,2024,playoff
greenaj01,SG,MIL,6,0,67,6,16,2,11,4,5,3,3,0,9,9,2,0,0,1,9,17,2024,playoff
greenjo02,SG,DAL,22,0,399,36,85,23,59,13,26,14,19,21,35,56,23,17,3,7,29,109,2024,playoff
hachiru01,PF,LAL,5,5,152,15,38,5,14,10,24,4,8,6,13,19,4,0,0,2,8,39,2024,playoff
halibty01,PG,IND,15,15,522,105,215,53,140,52,75,17,20,12,60,72,123,19,10,31,14,280,2024,playoff
hardati02,SF,DAL,14,0,178,22,58,13,37,9,21,4,8,2,23,25,5,5,1,2,10,61,2024,playoff
hardeja01,PG,LAC,6,6,242,40,89,18,47,22,42,29,32,3,24,27,48,6,6,14,13,127,2024,playoff
hardyja02,SG,DAL,19,0,129,29,68,11,27,18,41,11,15,2,13,15,17,3,0,7,13,80,2024,playoff
harriga01,SG,ORL,6,6,159,8,28,7,22,1,6,2,2,5,7,12,4,7,3,2,18,25,2024,playoff
harrito02,PF,PHI,6,6,218,22,51,6,18,16,33,4,4,9,34,43,9,1,3,3,11,54,2024,playoff
hartjo01,SF,NYK,13,13,548,66,150,22,59,44,91,35,48,37,113,150,59,13,10,34,41,189,2024,playoff
harteis01,C,NYK,13,13,388,45,76,1,2,44,74,19,22,49,53,102,46,4,12,19,41,110,2024,playoff
hausesa01,SF,BOS,19,0,283,36,84,27,71,9,13,4,4,8,33,41,11,5,3,3,20,103,2024,playoff
hawkijo01,SG,NOP,3,0,12,0,4,0,3,0,1,0,0,0,2,2,0,0,0,0,1,0,2024,playoff
hayesja02,C,LAL,4,0,24,0,2,0,0,0,2,1,2,3,9,12,1,0,0,2,7,1,2024,playoff
haywago01,SF,OKC,7,0,46,0,3,0,0,0,3,0,0,1,12,13,3,1,1,0,2,0,2024,playoff
herroty01,SG,MIA,5,5,185,30,78,15,43,15,35,9,10,0,18,18,27,2,0,14,10,84,2024,playoff
hieldbu01,SG,PHI,4,0,51,7,17,6,13,1,4,2,2,2,3,5,2,0,1,2,4,22,2024,playoff
highsha01,PF,MIA,5,0,126,10,28,3,16,7,12,1,1,2,12,14,8,1,1,4,14,24,2024,playoff
holidjr01,PG,BOS,19,19,720,97,193,35,87,62,106,21,22,37,79,116,83,21,12,29,40,250,2024,playoff
holidju01,SG,DEN,12,0,150,11,35,11,29,0,6,2,4,1,19,20,4,6,0,3,16,35,2024,playoff
holmgch01,C,OKC,10,10,345,59,119,13,50,46,69,25,33,14,58,72,21,7,25,19,26,156,2024,playoff
horfoal01,C,BOS,19,15,575,66,138,35,95,31,43,7,11,35,98,133,40,15,16,12,28,174,2024,playoff
houstca01,SF,ORL,3,0,14,1,2,1,2,0,0,0,0,1,1,2,0,0,0,0,0,3,2024,playoff
howarje01,SF,ORL,2,0,10,2,3,1,1,1,2,0,0,0,1,1,1,0,0,2,1,5,2024,playoff
hylanbo01,PG,LAC,3,0,12,3,7,1,5,2,2,4,4,0,2,2,4,0,0,1,0,11,2024,playoff
inglejo01,SF,ORL,7,0,68,4,12,2,7,2,5,1,2,2,11,13,12,3,0,0,3,11,2024,playoff
ingrabr01,SF,NOP,4,4,145,19,55,2,8,17,47,17,19,1,17,18,13,4,5,9,8,57,2024,playoff
irvinky01,SG,DAL,22,22,879,186,398,53,136,133,262,62,73,22,59,81,113,23,7,51,62,487,2024,playoff
isaacjo01,PF,ORL,7,3,147,16,39,10,27,6,12,2,2,10,24,34,3,5,9,4,7,44,2024,playoff
jacksan01,SG,MIL,5,0,60,5,11,2,6,3,5,0,0,5,6,11,10,5,1,3,10,12,2024,playoff
jacksis01,C,IND,15,0,154,23,43,0,0,23,43,11,18,21,27,48,7,3,13,4,24,57,2024,playoff
jacksre01,PG,DEN,12,0,117,16,48,8,23,8,25,2,2,2,13,15,12,2,1,8,12,42,2024,playoff
jamesle01,PF,LAL,5,5,204,56,99,10,26,46,73,17,23,4,30,34,44,12,5,19,11,139,2024,playoff
jaqueja01,SF,MIA,4,4,123,21,52,3,13,18,39,6,7,2,11,13,12,3,2,7,6,51,2024,playoff
jeffrda01,SG,NYK,4,0,20,3,8,2,5,1,3,0,0,1,3,4,0,1,0,0,2,8,2024,playoff
joeis01,SG,OKC,10,2,173,24,54,16,39,8,15,0,0,4,18,22,10,5,0,5,10,64,2024,playoff
johnsja01,PF,IND,1,0,1,0,0,0,0,0,0,1,2,0,0,0,0,0,0,1,0,1,2024,playoff
jokicni01,C,DEN,12,12,482,133,244,14,53,119,191,64,71,43,118,161,104,17,8,40,32,344,2024,playoff
jonesda03,C,CLE,2,0,9,0,0,0,0,0,0,0,0,1,1,2,2,0,1,2,0,0,2024,playoff
jonesde02,SF,DAL,22,22,647,77,160,24,65,53,95,22,30,33,43,76,27,11,21,18,54,200,2024,playoff
joneshe01,SF,NOP,4,4,141,16,41,8,24,8,17,12,12,6,14,20,10,5,1,11,15,52,2024,playoff
jordade01,C,DEN,2,0,13,1,2,0,0,1,2,2,2,1,2,3,0,1,1,0,4,4,2024,playoff
jovicni01,PF,MIA,5,5,128,16,36,9,22,7,14,6,7,2,31,33,11,5,3,6,9,47,2024,playoff
klebima01,C,DAL,13,0,219,16,39,12,28,4,11,4,6,4,21,25,13,3,4,5,20,48,2024,playoff
kornelu01,C,BOS,13,0,133,14,21,0,0,14,21,11,13,19,22,41,7,1,5,6,11,39,2024,playoff
lawsoaj01,SG,DAL,10,0,30,4,9,2,6,2,3,1,2,1,2,3,0,0,1,0,1,11,2024,playoff
leonaka01,SF,LAC,2,2,59,11,24,0,5,11,19,2,3,3,13,16,4,4,1,4,3,24,2024,playoff
leverca01,SG,CLE,11,1,278,44,102,6,33,38,69,17,26,8,32,40,25,9,6,14,14,111,2024,playoff
liddeej01,PF,NOP,1,0,3,0,0,0,0,0,0,0,0,0,1,1,0,0,0,0,0,0,2024,playoff
lillada01,PG,MIL,4,4,156,34,81,20,48,14,33,37,38,2,11,13,20,4,0,9,8,125,2024,playoff
littlna01,SF,PHO,4,0,14,3,5,1,3,2,2,0,0,0,1,1,0,0,0,0,2,7,2024,playoff
livelde01,C,DAL,21,0,462,64,95,1,1,63,94,36,61,57,99,156,27,9,20,21,48,165,2024,playoff
livinch01,SF,MIL,2,0,6,1,1,0,0,1,1,0,3,0,0,0,0,0,0,0,0,2,2024,playoff
lopezbr01,C,MIL,6,6,200,44,75,10,23,34,52,8,15,11,15,26,11,0,8,9,10,106,2024,playoff
loveke01,PF,MIA,5,0,32,4,9,1,4,3,5,0,0,1,13,14,4,0,0,2,2,9,2024,playoff
lowryky01,PG,PHI,6,6,175,11,32,8,24,3,8,12,15,6,15,21,24,6,4,4,23,42,2024,playoff
mannte01,SG,LAC,6,6,187,19,46,10,22,9,24,8,8,17,13,30,11,0,0,5,19,56,2024,playoff
marshna01,SF,NOP,4,0,84,12,28,6,15,6,13,6,6,3,8,11,5,2,2,2,9,36,2024,playoff
martica02,SF,MIA,5,5,176,21,45,11,25,10,20,5,5,5,13,18,7,3,0,3,14,58,2024,playoff
maxeyty01,PG,PHI,6,6,267,66,138,22,55,44,83,25,28,1,30,31,41,5,2,13,16,179,2024,playoff
mcbrimi01,PG,NYK,13,2,347,54,124,25,68,29,56,10,12,7,22,29,25,7,2,11,30,143,2024,playoff
mccolcj01,PG,NOP,4,4,148,31,74,7,29,24,45,2,2,2,17,19,19,7,3,16,14,71,2024,playoff
mccontj01,PG,IND,17,0,348,90,185,7,26,83,159,13,15,11,41,52,86,15,2,21,26,200,2024,playoff
mcdanja02,SF,MIN,16,16,537,72,140,24,56,48,84,27,35,28,33,61,18,14,18,17,54,195,2024,playoff
mcderdo01,SF,IND,10,0,64,5,11,3,8,2,3,0,0,2,1,3,7,0,2,1,5,13,2024,playoff
mclaujo01,PG,MIN,6,0,30,2,9,0,5,2,4,0,2,0,4,4,2,0,0,2,1,4,2024,playoff
meltode01,SG,PHI,1,0,7,0,2,0,2,0,0,0,0,0,1,1,1,0,0,0,1,0,2024,playoff
merrisa01,SG,CLE,10,0,125,10,29,10,27,0,2,3,3,2,10,12,9,0,0,0,9,33,2024,playoff
middlkh01,SF,MIL,6,6,230,55,114,11,31,44,83,27,30,12,43,55,28,3,1,14,25,148,2024,playoff
millele01,SF,MIN,3,0,7,0,1,0,1,0,0,0,0,1,3,4,0,0,0,0,0,0,2024,playoff
millspa02,PG,MIA,3,0,52,6,17,3,11,3,6,3,4,1,0,1,3,1,0,1,2,18,2024,playoff
miltosh01,SG,NYK,4,0,22,0,6,0,2,0,4,5,6,0,1,1,2,1,0,0,0,5,2024,playoff
minotjo01,SF,MIN,5,0,18,2,9,2,5,0,4,0,0,1,4,5,3,0,0,0,2,6,2024,playoff
mitchdo01,SG,CLE,10,10,382,107,225,29,82,78,143,53,65,6,48,54,47,13,3,28,29,296,2024,playoff
mobleev01,PF,CLE,12,12,422,81,146,5,18,76,128,25,36,30,81,111,28,10,26,22,34,192,2024,playoff
moorewe01,SG,MIN,6,0,18,3,7,1,4,2,3,0,0,0,2,2,2,1,0,1,3,7,2024,playoff
morrima03,PF,CLE,9,1,138,22,48,9,23,13,25,2,3,2,23,25,3,4,0,3,8,55,2024,playoff
morrima02,PF,DAL,1,0,12,1,5,1,3,0,2,0,0,0,4,4,0,0,0,1,1,3,2024,playoff
morrimo01,PG,MIN,9,0,67,9,30,1,14,8,16,2,2,1,5,6,9,2,1,0,6,21,2024,playoff
murphtr02,SF,NOP,4,4,168,18,48,10,30,8,18,0,0,3,23,26,9,5,6,8,12,46,2024,playoff
murraja01,PG,DEN,12,12,462,100,249,23,73,77,176,24,26,9,43,52,67,10,6,31,28,247,2024,playoff
mykhasv01,SF,BOS,8,0,32,3,12,2,9,1,3,0,0,1,4,5,1,1,0,2,3,8,2024,playoff
nancela02,C,NOP,4,0,84,10,17,1,4,9,13,4,6,15,18,33,7,2,0,7,9,25,2024,playoff
nembhan01,PG,IND,17,17,554,102,182,29,60,73,122,20,26,14,42,56,94,6,4,23,56,253,2024,playoff
nesmiaa01,SF,IND,17,17,559,61,141,22,79,39,62,34,37,19,65,84,37,11,9,23,66,178,2024,playoff
niangge01,PF,CLE,10,0,121,9,41,3,23,6,18,7,8,3,9,12,4,4,2,7,18,28,2024,playoff
nnajize01,PF,DEN,3,0,14,2,3,0,0,2,3,1,2,2,0,2,0,0,1,2,1,5,2024,playoff
nurkiju01,C,PHO,4,4,104,13,26,0,2,13,24,5,11,13,20,33,11,6,6,6,15,31,2024,playoff
onealro01,SF,PHO,4,2,104,7,22,6,18,1,4,0,0,5,14,19,4,1,0,2,11,20,2024,playoff
okekech01,SF,ORL,2,0,10,2,3,1,2,1,1,1,1,0,0,0,1,0,0,0,0,6,2024,playoff
okogijo01,SG,PHO,4,0,29,5,9,1,3,4,6,3,6,0,4,4,2,2,0,2,7,14,2024,playoff
okorois01,SF,CLE,12,7,263,25,70,9,35,16,35,7,9,5,16,21,13,11,4,11,30,66,2024,playoff
oubreke01,SF,PHI,6,6,224,31,64,9,23,22,41,8,11,9,15,24,10,11,7,8,24,79,2024,playoff
payneca01,PG,PHI,5,0,61,10,25,8,18,2,7,0,0,0,6,6,7,1,4,3,10,28,2024,playoff
pickeja02,SG,DEN,3,0,11,2,3,0,1,2,2,0,0,0,1,1,1,0,1,0,1,4,2024,playoff
plumlma01,C,LAC,6,0,66,7,18,0,0,7,18,5,8,7,13,20,4,3,2,2,13,19,2024,playoff
portemi01,SF,DEN,12,12,443,68,146,33,81,35,65,20,26,8,74,82,13,11,10,18,27,189,2024,playoff
portibo01,PF,MIL,6,6,187,44,91,3,12,41,79,8,13,16,52,68,6,3,1,9,13,99,2024,playoff
porzikr01,C,BOS,7,4,165,28,60,10,29,18,31,20,22,4,27,31,8,5,11,5,15,86,2024,playoff
poweldw01,C,DAL,13,0,44,1,3,0,0,1,3,4,6,3,9,12,3,1,0,3,9,6,2024,playoff
powelno01,SG,LAC,6,0,179,26,61,13,29,13,32,12,15,3,14,17,2,3,0,7,20,77,2024,playoff
princta02,PF,LAL,5,0,111,12,29,5,17,7,12,8,8,1,11,12,3,1,2,1,9,37,2024,playoff
pritcpa01,PG,BOS,19,0,355,44,105,23,60,21,45,11,12,14,23,37,40,4,0,14,22,122,2024,playoff
prospol01,PF,DAL,3,0,9,0,2,0,0,0,2,0,0,0,3,3,1,0,0,0,0,0,2024,playoff
quetane01,C,BOS,3,0,13,2,3,0,0,2,3,0,0,1,2,3,0,0,1,0,0,4,2024,playoff
reaveau01,SG,LAL,5,5,174,30,63,7,26,23,37,17,19,5,14,19,18,7,3,4,8,84,2024,playoff
reedpa01,C,PHI,6,0,43,4,9,0,0,4,9,1,2,9,7,16,2,1,3,3,7,9,2024,playoff
reidna01,C,MIN,16,0,361,65,142,25,69,40,73,22,31,9,50,59,16,8,12,14,32,177,2024,playoff
robindu01,SF,MIA,5,0,60,5,16,3,13,2,3,0,0,0,5,5,6,2,0,5,6,13,2024,playoff
robinmi01,C,NYK,6,0,115,7,14,0,0,7,14,3,8,23,18,41,3,6,7,3,15,17,2024,playoff
robinor01,C,MIA,1,0,2,0,1,0,1,0,0,0,0,0,1,1,1,0,0,0,0,0,2024,playoff
robinje02,PF,NOP,1,0,5,1,2,0,0,1,2,0,2,1,0,1,1,0,0,0,0,2,2024,playoff
roddyda01,PF,PHO,2,0,3,0,0,0,0,0,0,0,0,0,0,0,0,0,0,0,0,0,2024,playoff
russeda01,PG,LAL,5,5,185,28,73,14,44,14,29,1,2,1,13,14,21,4,1,9,6,71,2024,playoff
ryanma01,SF,NOP,1,0,3,0,1,0,1,0,0,0,0,0,1,1,0,1,0,1,0,0,2024,playoff
sheppbe01,SG,IND,17,2,335,31,71,19,50,12,21,7,9,10,41,51,17,8,1,11,32,88,2024,playoff
siakapa01,PF,IND,17,17,603,157,290,14,47,143,243,39,63,42,86,128,64,13,7,19,48,367,2024,playoff
simsje01,C,NYK,5,0,27,2,2,0,0,2,2,3,4,3,5,8,1,2,1,0,1,7,2024,playoff
smithja04,C,IND,7,0,42,3,8,2,4,1,4,5,8,7,7,14,2,2,1,4,8,13,2024,playoff
sprinja01,PG,BOS,4,0,22,2,3,0,0,2,3,0,0,0,3,3,1,0,1,2,1,4,2024,playoff
strawju01,SF,DEN,3,0,16,2,6,1,4,1,2,2,4,0,2,2,0,1,0,1,3,7,2024,playoff
strusma01,SF,CLE,12,12,434,42,103,25,72,17,31,5,5,8,56,64,35,9,0,15,41,114,2024,playoff
suggsja01,SG,ORL,7,7,232,33,82,14,48,19,34,23,30,11,25,36,23,9,3,20,18,103,2024,playoff
tatumja01,PF,BOS,19,19,768,159,372,39,138,120,234,118,137,17,167,184,119,20,13,50,54,475,2024,playoff
theisda01,C,LAC,1,0,4,1,1,1,1,0,0,0,0,0,1,1,0,0,0,0,0,3,2024,playoff
thomais02,PG,PHO,1,0,4,0,2,0,1,0,1,0,0,0,0,0,0,0,0,1,0,0,2024,playoff
thomptr01,C,CLE,10,0,87,7,16,0,0,7,16,1,2,10,10,20,10,1,5,2,9,15,2024,playoff
tillmxa01,PF,BOS,8,0,69,5,8,1,1,4,7,1,1,4,10,14,3,3,3,3,7,12,2024,playoff
toppiob01,PF,IND,17,0,343,73,135,20,56,53,79,19,25,10,65,75,29,6,6,14,21,185,2024,playoff
townska01,PF,MIN,16,16,522,108,232,30,83,78,149,59,69,35,109,144,42,12,3,27,55,305,2024,playoff
tuckepj01,PF,LAC,2,1,31,4,6,3,4,1,2,0,0,3,0,3,0,0,0,3,6,11,2024,playoff
turnemy01,C,IND,17,17,550,106,205,39,86,67,119,38,50,26,87,113,36,8,25,33,44,289,2024,playoff
tysonhu01,PF,DEN,3,0,14,0,4,0,3,0,1,1,2,1,2,3,1,0,0,1,0,1,2024,playoff
valanjo01,C,NOP,4,4,90,22,42,0,1,22,41,14,17,18,26,44,5,2,0,10,9,58,2024,playoff
vincega01,PG,LAL,5,0,69,3,12,1,7,2,5,0,0,1,7,8,3,2,0,3,8,7,2024,playoff
wadede01,PF,CLE,3,1,63,4,13,3,10,1,3,0,0,1,5,6,5,1,2,2,4,11,2024,playoff
wagnefr01,SF,ORL,7,7,259,42,103,9,34,33,69,39,44,10,38,48,31,5,9,9,20,132,2024,playoff
wagnemo01,C,ORL,7,0,105,16,36,2,9,14,27,10,17,11,20,31,2,6,3,8,21,44,2024,playoff
walkeja02,PF,IND,9,0,31,3,10,0,3,3,7,2,3,1,3,4,4,2,1,6,2,8,2024,playoff
wallaca01,SG,OKC,10,0,198,16,41,9,28,7,13,1,2,7,6,13,10,9,2,4,14,42,2024,playoff
walshjo01,SF,BOS,3,0,11,1,3,0,1,1,2,0,0,0,2,2,0,0,0,0,0,2,2024,playoff
warretj01,SF,MIN,3,0,11,0,2,0,1,0,1,0,0,2,1,3,1,0,0,0,0,0,2024,playoff
washipj01,PF,DAL,22,22,785,100,234,47,135,53,99,39,55,33,112,145,31,16,17,32,67,286,2024,playoff
waterli01,SG,OKC,3,0,9,0,1,0,1,0,0,0,0,0,1,1,0,0,0,0,0,0,2024,playoff
watsope01,SF,DEN,10,0,90,6,24,3,12,3,12,3,6,2,13,15,4,0,6,3,9,18,2024,playoff
westbru01,PG,LAC,6,0,114,13,50,4,17,9,33,8,13,6,19,25,10,7,3,10,11,38,2024,playoff
whitede01,SG,BOS,19,19,676,109,241,65,161,44,80,35,38,19,62,81,77,18,23,16,44,318,2024,playoff
wiggiaa01,SG,OKC,10,0,157,23,47,6,20,17,27,10,11,9,23,32,10,6,3,9,8,62,2024,playoff
willija06,PF,OKC,10,10,377,75,160,15,39,60,121,22,27,13,55,68,54,17,5,19,21,187,2024,playoff
willija07,C,OKC,10,0,127,16,33,9,22,7,11,3,4,4,28,32,15,4,3,3,11,44,2024,playoff
willike04,PF,OKC,7,0,32,2,8,0,5,2,3,0,0,1,7,8,3,1,0,0,3,4,2024,playoff
wrighde01,PG,MIA,4,1,107,12,20,6,10,6,10,2,2,2,10,12,7,4,1,0,5,32,2024,playoff
youngth01,PF,PHO,1,0,4,0,0,0,0,0,0,0,0,0,0,0,0,0,0,0,0,0,2024,playoff
zubaciv01,C,LAC,6,6,192,42,70,0,0,42,70,13,20,18,38,56,6,5,3,8,21,97,2024,playoff
